BRA(H)@g[G]	X
BRA(L)@g[G]	X
BRA@g[G]	X
DÅLIG(L)@g[G]	X
DÅLIG@g[G]	X
HEJ@g[G]	INTJ
HÄLSA@g[G]	X
KLAPPA_MAGE@g[G]	VERB
KLIA-HUVUD@g[G]	VERB
KÖPA@g[G]	VERB
LUGNA@g[G]	VERB
låta-vara@g@&[G]	X
LÅTA-VARA@g[G]	INTJ
MEN*PU@g[G]	X
PEK@g[G]	PRON
PF@g[G]	INTJ
PU.ADR@g[G]	INTJ
PU.TEX@g[G?]	X
PU.TEX@g[G]	X
PU.VARSÅGOD@g[G]	INTJ
PU@g>person[G]	INTJ
PU@g@hd[G]	X
PU@g[G]	INTJ
PÅKALLA-UPPMÄRKSAHET@g>person[G]	INTJ
